00000WWW0000WWW
0WWW000W0WW0W00
00WWWW000W00W0W
W0000WWWWWW000W
000W00000WWW00W
WW0WWWWW00000WW
000WWW0000WWWWW
0W000WW0W0WWW0W
0WW0WW00W000W0W
WWW0WW0WWWWWW0W
WWW0WW0W000000W
W000WWWW0WWWW0W
00WWW0000WW000W
W0WWW0WW0WW0WWW
W00000WW00W000G